33131323131321321132313222121313313221232222212323323312222221333332131213132212
11311222311213122333222333322333112231211132211121113331223133132232211111222112
11232321112312113332111331123323311321312313321112213121333211331211312111211122
23221323232331122222131332233322231132113331121323221311213121332221312313112132
33321323333111311321321212331232333323131123122123132231311332331321313332313312
12133311332222111321211231121322313221222232331121331132223313323212312132223332
23321122233323131322231113222132313222321212233231113121113321221333311123223332
13212133322212321323111312112223232221322131232133113333131223223213323333333312
21313321222231132333322211122112322111233222332312122123221113223112231221231332
32231121231213222222313112331323222121323322211323221223111211113121323211312232
23331212123122221221221221313313111223222223212313332313122111213331333313212132
13133121113112121333131312212231332212311133233112133112233111312232122312312212
23322311112232111322121133331222211121331311123231233311313232113231233111312212
31131332123121211232331213322332212232313133121111113132212233121131232332231232
32211332322321223221122312133313231133331332122211311233332112222221321121113312
23131312222213131322232132111223132112123332222312122322111231133321211222222312
23132132212231131331211122122133121111133133132222231111111331122233233231231322
11122213132312212131311212113112111132321223231333132132213111323113211113123112
33113322331113132233221222312212333121231123321112333223311231333312311322212212
33131122223112113131312312331331331111233331332123333122223112331113323133221122
31233333313233113332212331122123211131132222211213223331323313231222212123212212
12323333221232122332323213133321113131123213212222232223111212123111211121311222
12232221132112223123132133123131212111112322233323211221123221122222213213132222
33333321112312132121131113232232112232212221311322332322333312112233212123221312
21323233311121312331221222223232212133313213332132113222132313211233311322332232
23313132113121223122221213133123133311222122222111333313331233333223212321211212
31313312322313222113311123311122212233122111221121333131322122113121213221133112
22223312331323322111113213222133333332232223123212122313233132133123213321323332
12122211222213313212312222132333232113213331333132112212331111312221222323111112
22123112133323333122133121111212113321123132233223332123222221331212331212312212
21331212132312123223112313232223231222221133331232233332313221132123322213132212
31212123221313232312233211232213323123222323312221113133122132312332123232223222
12113111311322231331221131212331232313213212132332212213132211132232311113323312
33233132223221113112323111132322233211212122312231312311113213123232311113132322
33213333232211211232212232321123111312112222212233113131322123131331232233132232
32121231213222323233332213231133233131212332213323223213211212333211122121223322
21111322113311113132131322132332221333211131313211233231222222323132322133211212
31131213122211123311333312111132222321212121233221233333312222133122131331111222
31312122332213222322333121321131221231113123121211111332323131122212231323332122
23131322323313121232231332323312122133322332122223232222312122133323311321221322
33132232212123222232333333311212322113222222321231211113121221111231221213223232
21323212112133111323313122121121122313112121133121233231131221212121213312131332
21111231321121123331222313213212112321321133311313223313132311121322232312121212
31223333131232113132333311112222213132113131313122322311233231221133111122211112
13111323221232123111322233121211331322121232312322311222332113332123132232233222
33112132332321221212323221133232112313323223133312312213233233311331121321222232
33121131332211131212211333312211122313321333231133231233113213221131113131333232
11332111211321131322232233331211131312113333311222221111323211112311132123122212
13322233113113121313221213211132322231233312321131331213312211311311313123211122
31233312122321212312232232223112333332111311132132111132311233113233223222112212
13312112113232223331123112211123123222332213213133123232333211222111313311213312
23232221233332322312131122121113213123133311213121321221113112221333212111233332
13231321223313213332331113132311332223212123112131333333121222212313331211333212
11232332322221233223131233131233312333133313211221213112113321112323323113332322
11121121211221312111321213123232211211213131122122113223333111311233232333121212
22313213131122212222113232221321222333333133112322213211232221113112131133222112
11311331221133222112111121312113122122132122211333313112211222123322111222122212
12332132312121213313121311321112132222132213131123321133123123313211113113231232
12111232223133132313312213321313222223331131231333213223332123333212131332113322
12332223211213133123133231313312123111131221131113222313221211121311322333212132
32212131332213222332231132113232211223123122232233111322332231233121323123311222
21322332123223213221312323121211123321131322322121211313213332213113313321333312
13112131213113133132211323122112113332313213223212221323223113122211213323312332
23213122122333321231121333133331322233311213232322232231212222333113131312311122
32212332213132312322221231111332121133121222222122322211312331121321223111231222
11111331123211333323113322332122231133221113132112111112123222333212231311112212
32211313333321213121121312131133133312323121123211233113322211212123112321232112
11112313112211233332121311321122332312232231333122331121112112231212313231212232
12312313321232311311323112233132112333121122221132311132223111231223311223132332
13112323223113333333212122111111331222221332131222131233131121212333313113112212
32311332321313333311131312331121321121132123121231313233332323322133113212223322
11121122331313132231331121132323122323223323222331133322223121322331122212332232
23312322222133323113213133231331113112132123222212311332311231331213321222331322
23213311131133211232333123112231321112123233322231233223313313311231311121123222
21222221223133212131231222223121211111222313231323131123132322223123323221231332
12312123322121213221232311233231132321213321321121213132222131333113122331123122
22231321213212333311233232223323212233321223333322223311232323221321221312222112
13121121121233333121231133321112222321233331221331213323311312332221132131212112
32323122232222323321222211131132113332322312113112323333232231223213211311113232
11111111111111111111111111111111111111111111111111111111111111111111111111111110